00000000000000000000000000
00000011111100001100000000
00001111111111111111000000
00111111111111111111000000
00555555555555555511110000
00555555555555555511110000
55550000000000005555111100
55550000000000005555111100
55002200002200000055555500
55002200002200000055555500
55002200002200000055555500
55002200002200000055555500
55000055000000005555111110
55000055000000005555111110
55555555555555555511111110
55555555555555555511111110
11555511115555551111111100
11555511115555551111111100
00111111111111111111110022
00111111111111111111110022
22001122111111111111100022
22001122111111111111100022
00221111220000001111222222
00221100220111101111222222
00000000000100100000000000
00000000000100100000000000
6 2 8 4