00000000220000000000000000
00000000220000000000000000
22220000220000222200000000
22220000220000222200000000
00220000220000002200222255
00220000220000002200222255
00220000222222005500220000
00220000222222005500220000
00110000000022002222220000
00110000000022002222220000
55222200221122111100000000
55222200221122111100000000
00002255225500001100002222
00002255225500001100002222
00002200005500002200002200
00002200005500002200002200
00001100002200002222112200
00001100002200002222112200
55222222555511222200112200
55222222555511222200112200
00000011000000005555001100
00000011000000005555001100
00000022000000000055001100
00000022000111100055001100
00000022000100100022001100
00000022000100100022001100
2 8 2 8