00000000000000000000000000
00000000000000000000000000
00011111000000000000111110
00010011000000000000110010
01110000110055550011000001
01000000110055550011000001
11000000115555555511000001
11000000115555555511000001
11000001115522225511100011
11000001115522225511100011
01000011333333333333111111
01111111333333333333111111
00111111222211222211111110
00111111222211222211111110
00001111220011002211111000
00001111220011002211111000
00001111111111111111111000
00001111111111111111111000
11551111112222111111115511
11550000002222000000005511
11555555555555555555555511
11555555555555555555555511
00005555550000005555555500
00005555550111105555555500
00000010000100100000100000
00000010000100100000100000
12 2 4 2