00000000000100105555000000
00000000000100105555000000
00100200100000000155100155
00100200100000000155100155
00100200100011000155100155
00100200100011000155100155
00110000110022001155001155
00110000110022001155001155
00000001220011001120005555
00000001000011000020005555
11111000005511550000011111
11111000005511550000011111
00000000015555551000000000
00000000015555551000000000
22111100115555551101111122
22111100005555550001111122
22222200000055000000222222
00000000110055001100000000
00110000110000001100000000
00110000110000001100000000
00111000001100110000011155
00111000000000000000011155
00001100000000000000555555
00000000000111100000555555
00000000000100100000005555
00001100000100100000115555
9 2 7 2