00000000000000000000022000
00000000000000000000022000
00000000000000000000220000
00000000000022000000220000
00000000000055000011100000
00000000001155110011100000
00000000005555550011100000
00000000225555552211100000
00000000555544555511100000
00000011555544555511100000
00000055554444445555100000
00002255554444445555100000
00005555444444444455550000
00115555444444444455551100
00555544444444444444555500
22555544444444444444555522
55554444444444444444445555
55554444444444444444445555
00554444444444444444445500
00554444444444444444445500
00554444444444444444445500
00554444444444444444445500
00554444440000004444445500
00554444440111104444445500
00554444000100100044445500
00554444000100100044445500
15 2 2 1