00000000000000000000000000
00000000110000001100000000
00111111110000001111111100
00111111110000001111111100
00110000000011000000002200
00110000000011000000002200
00220011110000001111001111
00220011000000000011001111
00110010550022005501002211
00110010552222225501002211
00110000555555555500002211
00000000555555555500000011
11000000555555555500000011
11220000555555555500001111
11220010552222225501001100
11220010550022005501001100
11110011000000000011002200
11110011110000001111002200
11220000000011000000001100
11220000000011000000001100
11111111110000001111112222
11111111110000001111112222
11110000110000001100001100
11110000000111100000001100
11110000000100100000000000
11110000000100100000000000
0 8 8 4