00000022000000220000000000
00000022000000220000000000
00110022000000110011001100
00110022000000110011001100
00110000000011110011221100
00110000000011110011221100
00000011000000000022000000
00000011000000000022000000
55000011000022000011551122
55000011000022000011551122
55550000001100002200550000
55550000001100002200550000
00111111555555220000551100
00111111555555220000551100
00000022551100110011001100
00000022551100110011001100
22110022001100110000001100
22110022001100110000001100
00110011001111110011221100
00110011001111110011221100
00110011001111110000000000
00110011001111110000000000
00110000000000000011001100
00110000000111100011001100
00110011000100100011111100
00110011000100100011111100
14 4 0 2