00000000000000000000000000
00000000000000000000000000
00000000002222000000000000
00000000002222000000000000
00000000000022000000000000
00000000000022000000000000
00222255551122115555222200
00222255551122115555222200
00000022555522555522000000
00000022555522555522000000
55000000225555552200000055
55000000225555552200000055
22550000005555550000005522
22550000005555550000005522
55000000002255220000000055
55000000220055002200000055
00000000220000002200000000
00000000220022002200000000
00000022000022000022000000
00000022000022000022000000
00000000000000000000000000
00000000000000000000000000
00000000000000000000000000
00000000000111100000000000
00002200000100100000220000
00002200000100100000220000
0 10 4 6