00000033000000003300000000
00000033000000003300000000
33330033003333333300333333
33330033003333333300333333
55551100001100003300335533
55551100001100003300335533
55333333330022000011555555
55333333330022000011555555
55550033000033003333333355
55550033000033003333333355
33330033003333000033000000
33330033003333000033000000
00001155110011550033000033
00001155110011550033000033
00333355333333330055110033
00333355333333330055110033
11000011000033005555330033
11000011000033005555330033
33330033330033113333330000
33330033330033113333330000
00001100555500005533000033
00001100555500005533000033
00333333550000000033003333
00333333550111100033003333
00330000000100100000000000
00330000000100100000000000
0 8 6 6