00555500000000000000005500
00555500000000000000005500
55550000001111000000000055
55550000111111111100000055
55000001111111111111000022
55000001111111111111110000
22000011111111111111111000
00000011111111111111111000
00000111000000111111001000
00000100000000001111001000
33000100200020001110000000
33000100200020001110000000
00001100000000001110003333
00001100111100001110003333
00001111111111111111000000
00001111111111111111000000
00011111111111111111100000
00011111111111111111100000
00111111111111111111110000
00000011111111111100000000
00111100111111110011110055
00111111001111001111110055
55001111000000001111005555
55000000000111100000005555
22550000000100100000555522
22550000000100100000555522
16 4 0 0