00000000220000000022000000
00000000220000000022000000
00220000002200002255550000
00220000002200002255550000
00002200000000225500200000
00002200000000225522200000
00000022005555555555000000
00000022005555555555000000
00200000225555225500000000
00200000225555225500000000
00222055002255552200000000
00002055002255552200000000
00005555555555000022000000
00005555555555000022000000
00002055002255000000220000
00222055002255000000220000
00555555220022000000002200
00555555220022002200002200
55555522000000000200000000
55555522000000000200000000
00002200000000000000000222
00002200000000000000000222
00000000000000000000200000
00000000000111100022200000
20000000000100100000000000
20002200000100100000000000
0 8 4 8