00000000002200110011110000
00000000002200110011110000
00011111111100110000000000
00011111111100110000000000
00000010001100111100555555
00000010001100111100555555
00010000000000220055555555
00010000000000220055555555
00010011111122111155551122
00010011111122111155550022
00111111220000110055550001
00000000220000110055550001
01111111002255555555550000
01111111002255555555550000
00000022000055555555551100
00000022000055555555551100
22110055555555225555551100
22110055555555225555551100
01115555555555000000001110
01115555555555000000001110
00115555000000002211111100
00115555000000000011111100
00005555000000000011000100
00005555000111100011000100
00005555000100100000000000
00115555000100100000000000
0 10 4 6