00000000000000000000000000
00000000000000000000000000
00000000110011000000000000
00000000110011000000000000
55000055115511550000550000
55000055115511550000550000
11555511111111115555115500
11555511111111115555115500
11111111221122111111115500
11111111221122111111115500
33333311111111113333335500
33333311111111113333335500
33111111111111111111333355
33111111111111111111333355
11111133111111331111115555
11111133111111331111115555
11113333331133333311113333
11113333331133333311113333
55333355555555553333553355
55333355555555553333553355
00555500000000005555005500
00555500000000005555005500
00000000000000000000000000
00000000000111100000000000
00000000000100100000000000
00000000000100100000000000
0 6 4 10