00000022001100110011002200
00000022001100110011002200
00110011000000000022000000
00110011000000000022000000
00110011000022000022002222
00110011000022000022002222
00110000001100221100000022
00110000001100221100000022
00000000111100111100220000
00000000111100111100220000
00002200110000111100111100
00002200110000111100111100
22002200001100220000221100
22002200001100220000221100
00001111001100000011220000
00001111001100000011220000
00221111001111001111000011
00221111001111001111000011
00110000001122000000001111
00110000001122000000001111
00000011001111220022000011
00000011001111220022000011
11001111000000000011220000
11001111000111100011220000
11001100000100100011111100
11001100000100100011111100
0 8 2 10