00000033001100001100110000
00000033001100001100110000
00000000000000001100220000
00000000000000001100220000
00000033000022001100110000
00000033001122001100110000
22001133002200001100110000
00001133002200110000110000
00001133000000110000000000
00001133000000110000000000
11001133330033333333000011
11001133330033333333000011
00000000000000550033002222
00000011000000550033000000
11110111002255555533000000
11110111002255555533001111
11000100001155555533001100
00000100001155555533001100
00000000001100550033005500
00220000001100550033005500
00110000001111110000555555
00110022000000000000555555
00110011000000000033555555
00110011000111100033555555
00000000000100100033005500
00000000000100100033005500
2 8 2 8