00000000000000000000000000
00000000110000000000110000
00110011110000444444111100
00110011110000444444111100
00110000110022444444444400
00110000110022444444444400
44444420110000114444444400
44444420110000114444444400
44444444444411110110000000
44444444444411110110000000
00000244444444110110002222
00000244444444110110000000
11111111444444444444441111
11111111444444444444441111
00000011114444444420000000
00000011114444444420000000
00111111004444441111001100
00111111004444441111001100
44444411440000000011001100
44444411440000000011001100
44444444442200220000001100
44444444440000000000111100
11444444440000000011000000
11444444440111100011000000
11112000000100100011001100
11112000000100100011001100
8 2 0 10