00444444444400444444444400
00444444444400444444444400
44444444444444444444444444
44444444444444444444444444
44444411444444444411444444
44444411444444444411444444
44110011001144110011001144
44110011001144110011001144
44111111000000000011111144
44000011000000000011000044
44444411001122110011444444
44444411111122111111444444
22444444002200220044444422
22444444000000000044444422
44444444000000000044444444
44444444001100110044444444
44444444001100110044444444
44444444001100110044444444
44444411000000000011444444
44444411000011000011444444
44114411002222220011441144
44114411000000000011441144
00110011000000000011001100
00111111000111100011111100
00110000000100100000001100
00000000000100100000000000
6 4 2 8