000000000000000000110000
00000000000000000000110000
00113333002200110000000000
00113333002200110000000000
00003333115555553333002200
00003333115555553333002200
00000000005555553333110000
00000000005555553333110000
00220000333300550000000000
00220000333300550000000000
55551100333322000000001100
55551100333322000000001100
55555500000000000022000022
55555500000000000022000022
00113333001100000000000000
00113333001100000000000000
22003333555533335555001100
22003333555533335555001100
00000000550033335555333300
00000000550033335555333300
00000022550000005555333300
00000022550000005555333300
00001100110000000000000000
00001100110111100000000000
11000000000100100011220000
11000000000100100011220000
0 4 10 6