00000000111100001100000000
00000000111100001100000000
00555511110000001100000000
00555511110000001100000000
55555555555555551111000000
55555555555555551111000000
55221155111111555555551122
55001155111111555555551122
55551155555522555511201100
55551155555500555511201100
00555511005555555511001100
00555511225555555511001100
00111111111155551111105555
00111111111155551111105555
02221111000000111100000055
02001111000000110000000055
00110011000000115555111055
00110011002211005555111055
00110000011111555511000055
00110000011100555511000055
00111110011155550055115555
00111110010055551155115555
00001100550000001155115500
00001100550111101155005500
00001100000100100055555500
00000000000100100055555500
2 10 0 8