00003333000000000000000000
00003333000000000000000000
00000033550010000000000000
22000033550010000000000000
55000000000020001000333300
55220000000020001000333300
55550000000100002055330000
55550022000100002055330000
55555500112200010000000000
55555500002211010000000022
55552200000100220000000055
55550022000100221100002255
55220000112200010022005555
55000000002200010000005555
00000000001011220000555555
00000000001000220000555555
00003355020000101100225555
00003355020000100022005555
00333300010002000000000055
00333300010002000000000055
00000000000001005533000022
00000000000001005533000000
22000000000000000033330000
22000000000111100033330000
22220000000100100000000022
22220000000100100000000022
4 6 4 6