00000000000000000000000000
00000000000000000000000000
55550000001111110000005555
55550000111111111100005555
55000001111111111110000055
55000001111111111110000055
00000011115511551111000000
00000011115511551111000000
00000011555511555511000000
00000011555511555511000000
55000011111111111111000055
55000011111111111111000055
55550000115511551100005555
55550000115511551100005555
33333300111111111100333333
33333300111111111100333333
00000000010101010100000000
00000000010101010100000000
00000000101010101000000000
00000000101010101000000000
02020200000000000000202020
02020200000000000000202020
10101000000000000000010101
10101000000111100000010101
20202002000100100020020202
20202002000100100020020202
0 4 10 6