00000000000000002222225500
00000000000000002222225500
00110000000000002200002200
00110000000000002200002200
11551100000011111111002200
11551100000011111111002200
00115511000011005511222200
00115511000011005511222200
00001100552211550011000000
00001100552211550011000000
00000000220011221111000000
00000000220011221111000000
00001111221100220000000000
00001111221100220000000000
00001100551122550000000000
00001100551122550000000000
22222255001100001111000000
22222255001100001111000000
22001111111100001122220000
22001111111100001122220000
22000022000000000022111100
22000022000000000022111100
55222222000000000000112222
55222222000111100000112222
00000000000100100000002222
00000000000100100000002222
2 8 6 4