00000000110000001100000000
00000000110000001100000000
00555555110000000000000000
00555555110000000000222222
11555555000000000000000000
11555555000000000000000000
55555555000000110011111110
55555555000000110011111110
55555555111111110011000100
55555555111111000011000100
55555555000011000000000100
55555555000011000000000100
00550000000022222200005500
00550000000022222200005500
00000000000000000055555555
00110011000000000055555555
11100111100111111155555555
11100111100100000055555555
00000000001100000055555555
00000000001100111155555555
11000020000000111155555500
11000020000000000055555500
11110020000000000055555500
11110020000111100055555500
22111100000100100011000000
22111100000100100011000000
14 4 0 2