00002200112200000000010000
00002200110000000000010000
00001100115500111111110000
00001100115500001111110000
00555500115501100000002222
00555500115501100000002222
55555555555511111100011100
55555555555511111100011100
00005555000022110001111101
00005555111100110001110001
11220000111100000011110001
11000011000000000011000001
01000011444444444444444444
01001111444444444444444444
01001100444444444444444444
01000000444444444444444444
00002200444444444444444444
00002200444444444444444444
11001100444444444444444444
11001100444444444444444444
01001100444444444444444444
01001100444444444444444444
01001100000000004444444444
01001100000111104444444444
00001100000100100044444444
00000000000100100044444444
10 4 4 2