00110011001100110011001100
00110011001100110011001100
00110011001100110011001100
00110011001100110011001100
00220022002200220022002200
00000000000000000000000000
00000000110000001100000000
11001100110000001100110011
11001111110011001111110011
11001100110011001100110011
22002200220022002200220022
00000000220000002200000000
55550000110055001100005555
55550000110055001100005555
55555555111155111155555555
55555555110055001155555555
55555555555555555555555555
55555555555555555555555555
00000000115555551100000000
11001100115555551100110011
00110011000055000011001100
00110011000055000011001100
00110011000000000011001100
00110011000111100011001100
00110011000100100011001100
00000000000100100000000000
4 4 4 8