00000000000000111111000000
00000000000000111111000000
00111111100000000011000000
00111111110011000011000000
00000000110011000000001111
00000000110000000000001111
00333333333300111000001122
00333333333300111000000100
00000000003300110022200100
00002222223300110022200100
11001111113333330033111100
11001111113333330033111100
00000000223300000033220000
00000000223300000033000000
33333300333311110033000000
33333300333311110033000000
00000000001122220033333300
00000000001100000033333300
11111100000000000000000000
11111100000000000000000000
00001100222200000011110001
00001100000000000011110001
11000000000000000011000011
11000000000111100011000011
00000000000100100000000000
00000000000100100000000000
0 6 8 6