00000011000000000000550000
00000011000000000022550000
11000000000000550222200000
11000000000022550222200000
00000000550222200022550000
00000022550222200000550000
00000222200022550000000000
00000222200000550000000000
00000022550000000000000000
00000000550000000000000000
00000055005500550055000000
00000055225500552255000000
22110002222000022220001122
22110002222000022220001122
00000055225500552255000000
00000055005500550055000000
00000000000000000000000000
00000000220000002200000000
11000002222000022220000011
11000002222000022220000011
11000055225500552255000011
11000055005500550055000011
00000000000000000000000000
00001100000111100000110000
00001111000100100011110000
00001111000100100011110000
6 4 7 3