00000000005500000000000000
00000000005500000000000000
00000000552255000000000000
00000000552255000000000000
00005500005500005555000000
00005500005500005555000000
00551155000000551111550000
00551155000000551111550000
00005511550000005555000055
00005511550000005555000055
55000055000055000000005522
55000055000055000000005522
11550000005522550000550055
11550000005522550000550055
22115500000055000055225500
22115500000055000055225500
11550000550000005500550000
11550000550000005500550000
55000055115500551155000000
55000055115500551155000000
00000055115500005500005500
00000055115500005500005500
00550000550000000000552255
00550000550111100000552255
55225500000100100055115500
55225500000100100055115500
6 8 2 4