00000000000000000000000000
00000000000000000000000000
00000000000000000000000000
00000000001111000000220000
00000000005555000000550000
00222200115555220011551100
00555500555555550055555500
11555511555555551155555511
55555555555555555555555555
55555555555555555555555555
22553355555555553355555555
22553355555555553355555555
55553333335555553333335522
55553333335555553333335522
55555555335522555555335555
55555555335522555555335555
55555555555555555555555555
55555555555555555555555555
55555555551111555555555522
55555555550000555555555500
22555555110000115555552200
00555555000000005555550000
00221111000000001111110000
00000000000111100000000000
00000000000100100000000000
00000000000100100000000000
4 8 4 4